width=7

X     X
XXX XXX
XXX XXX
XXX XXX
XXX XXX
XXX XXX
XX   XX
XX   XX
XX   XX
XX   XX
XX   XX
X     X
X     X
X     X
X     X
X     X








  
X     X
XX   XX
XX   XX
X     X
  
  XXX 
 XXXXX
 XXXXX
  XXX  

X     X
XX   XX
XX   XX
X     X

  XXX
 XXXXX
 XXXXX
  XXX


X X X X
X X X X
X X X X
X X X X


 X X X 
 X X X 
 X X X 
 X X X 

 
X X X X
X X X X
X X X X
X X X X


XXXX XX
XXX   X
XX  X X
X  XX X
X XX
   X XX 
 X X  
 X XXX 

X XX XX 
X X   X
XXX XXX
X     X 
X XXX X
X XXX X



 X X X

X X X X

 X X X

X X X X

 X X X

X X X X

XX   XX
XX X XX
XX   XX
X     X



  XX  
  XX  


XXXX  X
XX
XX X  X
XX X  X 
X  XXXX 
X   XXX
X    XX
X     X
 
end